1379650,3723473607,1
1304870,3230694902,1
1400050,4293666013,1
1048330,1788275658,1
1165670,3561001521,1
1202440,2180702912,2
1017070,453419894,8
1585410,3145960709,1
1383240,3995927070,1
1289370,1984279951,2
1140190,3245464230,3
1465590,3743568900,2
1012050,3145955489,7
1163940,1359812797,1
1582920,1661299652,6
1586700,4217688407,1
1008630,4283757120,1
1889610,794463579,1
2826528,2204757305,4
1576150,4071303920,1
1512610,2721679447,1
1516930,3936334116,1
2836191,2619847853,1
1570620,2885417320,1
1188500,9409787,1
1350110,2822456395,1
1508070,4210519197,1
1372630,3193679330,1
1382280,1565459330,1
1268070,4042628987,1
1580640,1362984759,2
1123520,192443749,1
1466970,980918597,1
1301460,2797659088,1
1267280,2008596695,1
2844926,104359212,1
2244450,2886115436,4
1008350,2091575906,1
1441690,2906900856,1
1290800,1721086025,2
1492570,1613601697,2
1007340,1339419198,1
1445770,2827590271,3
1171010,1713511370,2
1313580,1661298782,1
1009600,1330442727,1
1544520,4127858624,1
1006420,3836978890,1
1207590,1020149719,1
1521400,2843142192,2
2600340,1055021072,1
1505990,355011464,1
1123880,4035865712,8
1006970,3897411395,1
1421700,895810114,1
1008340,3145255706,1
1595730,3681539999,1
1384830,4009102962,1
2067670,3657107260,1
1012800,3916709715,1
1554820,3265394767,4
1357980,1831945900,1
2394370,2008526562,1
1514110,1958519444,3
1577980,895877539,1
1556100,1750932630,1
1927680,3693842541,1
1361490,1732750661,1
1207270,1969844272,1
1544590,3617771365,1
1014200,410114827,1
1304680,3580494318,1
1589500,3864570592,1
1365980,3291093986,1
1600780,2287048014,2
1115010,2607384471,2
1375610,4283029021,3
1620400,1737097940,1
1583250,895883194,6
1170660,2337363024,1
1004550,914552696,7
2527710,2452160006,2
2055530,1339424853,1
1099480,3386670465,3
1049870,3299489607,2
9000009,2886320972,1
1326980,3980866919,3
2122310,2204756435,1
1598970,755121258,1
1180470,3941290828,9
1363940,200983451,1
2028990,2204742950,25
1524630,644327912,1
1260490,759004422,1
2303570,243789590,1
1130140,4254542832,1
1164390,3834496112,1
1178920,2024674295,1
2577750,2204767310,1
1421850,3941296918,2
1004790,3939408094,1
2187550,1137531890,2
1221690,698740229,1
1404975,1868087303,1
1307510,766564339,1
1002980,3657104650,6
1530040,2496120560,1
2028940,2204193110,10
2029010,2204186150,32
2089490,4074908594,1
1312420,2431658776,1
1243230,2991913479,1
1423310,1737097940,2
1484150,541756562,7
2028950,3980803844,1
1581590,2519781863,8
1516460,1819955503,1
1922760,3198460061,1
1372120,4198561226,1
1546120,3759115764,1
1593670,4250094483,1
1588880,1214456128,1
1269320,2008529607,1
1006380,76748642,1
2087820,4070793607,1
1011660,3854211849,1
1600260,2640829281,1
2844416,3701621793,1
2028960,2204193980,3
1296400,2007970197,3
1553270,751213567,1
1641170,2170466188,10
1403830,3896851985,1
1333550,449259523,1
1549140,3574403100,2
1048830,927475967,58
2070970,2779383782,1
1525680,3145970714,5
1578850,895804024,3
1054230,2162296081,3
1315920,2933416814,1
1445640,4074919904,1
1420840,2686868849,1
2829815,3979957974,1
1524610,3145956359,1
1546640,895877539,2
1000920,3420632260,1
1207240,1970413687,2
1012480,3723549732,1
1088740,3215325849,1
1326940,628672851,1
1293990,3692015061,1
1116840,3320021866,1
1193540,4037374286,2
1352130,1198612971,3
1067210,2448048430,13
2024700,2008543962,3
2080110,1260930360,2
1576760,1955329364,2
1065860,4050140277,4
5741726,2554631912,7
1412890,1214476138,1
1535910,1827194840,1
1612950,3704949048,3
2831062,783179129,1
1202640,3720798819,1
2711110,3941299093,7
2682360,2884308863,1
1589590,614615490,1
1535880,1156749565,1
2150023127,3222694489,8
2028920,2204744690,30
1543910,3980648309,1
1612620,49234792,1
2086960,2379595516,1
2266960,2736353140,8
1087820,3945703495,1
1315840,3980790794,2
1533610,3489043599,2
1087690,4280154410,10
1270760,1454189429,1
2089020,2204745995,4
1602150,1362400119,3
1445150,2519771423,1
1008490,2204742515,15
1431800,1786638030,2
1009980,2452146086,1
1146750,2463900503,1
2198720,715501267,1
1188420,1239004008,1
1344410,1339125198,2
2136890,2749783340,2
1270730,2132361780,1
1307130,851346041,1
1128530,238742797,3
1628500,548169701,2
1003430,394053827,1
1499150,1705113358,1
1009470,4283028151,2
1965910,2516227376,1
1160790,895789234,3
1344380,2866982556,1
1469800,2204745125,120
1338240,2094085577,2
1410500,3310973283,1
1510790,397115350,1
2186280,1047243925,15
1307720,1612505528,1
1555300,383433366,4
1226360,312688573,2
1628530,1661086937,1
1547720,2798731624,1
1416220,2519779253,6
1009330,3357984352,2
1587610,895883194,4
2028970,2204756870,5
1044620,1926093948,3
1173030,3542792377,1
1157080,2519463878,3
1302680,4074931214,4
1478200,4167887056,2
1217700,125662877,1
1098320,417092505,1
1292300,2287253323,1
1214330,3341891661,1
1009990,2452154786,1
2028980,2204748170,20
1280310,1464846956,2
1315720,3723564522,1
1344470,1556463307,2
1405800,3838513365,1
2150759637,1115674066,1
1307500,1049400110,5
2519570,3980786879,16
1596950,1294816084,2
2443700,2197260439,1
1008860,860209177,1
1587040,895800979,1
1425790,546936248,5
1126140,3392656859,1
1605460,807582496,6
1612050,1713067064,1
1260530,3225515157,1
1228650,1372010838,1
1228470,1859822911,4
1450270,1550017167,3
1006730,4250210705,1
1589350,2211042752,1
1611260,1752033749,1
1356690,1088372671,1
1524230,3353565108,1
1582820,256873939,4
2759480,2938123444,1
1525000,3817053766,1
1913290,1622300984,1
1160820,2193020295,1
1001670,629715420,6
1362490,3723473607,6
1293810,1511856652,1
2453510,2360388790,2
1508560,2828747268,1
1288810,1661287907,11
1578840,2456644269,1
1482410,523736609,3
1283190,1383277865,2
1223440,1679745274,5
1008910,157196650,1
1894690,3372763509,1
1168660,2195601894,1
1327090,3723473607,6
1340450,450331373,2
2029000,2204749475,14
1402540,4251369015,1
1459690,4283580601,2
1591710,4012047435,3
1550270,697614180,1
1073060,388379314,2
1338850,1551861122,1
1157170,460825390,14
1348870,903790022,1
2028930,2204758175,28
1223615,2892243882,4
2402210,263203763,1
1259290,2104828696,3
1391560,4225079065,2
1519830,2984462260,1
1387210,1964082499,5
5082088,1751785534,10
1373860,4054020485,2
1859880,937290992,1
1208020,4228360418,1
1604570,1859839621,2
1189980,2738163500,1
2267260,3180245166,1
1582000,783753764,1
1013290,1675238252,1
1106250,2164676398,5
1579070,351558918,1
1289740,1637446580,1
2021030,3980866919,5
1576250,2900279453,1
1378520,2456444604,1
1069210,1863782111,2
2215430,3242553423,3